20
111111111111111111113
121000000000000000001
101011111111111111101
101010000000000000101
101010111111111110101
101010100000000010101
101010101111111010101
101010101000001010101
101010101011101010101
101010101019101010101
101010101000101010101
101010101111101010101
101010100000001010101
101010111111111010101
101010000000000010101
101011111111111110101
101000000000000000101
101111111111111111101
100000000000000000001
111111111111111111111