15
111111111111111
100000010000001
100000010000001
100000010000001
100000010000001
100000010000001
100000010000001
100010010010001
100000000000001
100001000100001
100000020000001
100000010000001
100000030000001
100000090000001
111111111111111