10
1111111111
1910000001
1030000001
1000000001
1000000001
1000100001
1000100001
1001100001
1000000021
1111111111