15
111111111111111
100010090010001
100010010010001
111010010010111
101001010100101
101000010000101
101000040000101
100110000011001
100000010000001
100001000100001
100000010000001
100110000011001
100110010011001
100110020011001
111111111111111