15
111110111111111
130010100000091
100010100000001
100010100000001
111011100000001
001000001111001
111000001001001
100011111001111
100010000000000
101011100111111
100000111100001
100000000000001
111001111100001
001001000100021
001111000111111