15
111111111111111
100000000000001
101000000000101
101000000000101
101000000000101
101000010000101
101000111000101
100000020000001
111111101111111
100000000000001
100000000000001
100000000000001
100000040000001
100000090000001
111111111111111