15
111111111111111
190000000000031
100000000000011
100000000000001
100000000010001
100000000000001
100000001000001
100000000000001
100000100000001
100000000000001
100010000000001
100000000000001
101000000000001
100000000000021
111111111111111